Skip to content
 
SIGN IN
Publish your passions, your way

Create a unique and beautiful blog. It’s easy and free.

CREATE YOUR BLOG
Choose the perfect design

Create a beautiful blog that fits your style. Choose from a selection of easy-to-use templates – all with flexible layouts and hundreds of background images – or design something new.

Get a free domain

Give your blog the perfect home. Get a free blogspot.com domain or buy a custom domain with just a few clicks.

Earn money

Get paid for your hard work. Google AdSense can automatically display relevant targeted ads on your blog so that you can earn income by posting about your passion.

Know your audience

Find out which posts are a hit with Blogger’s built-in analytics. You’ll see where your audience is coming from and what they’re interested in. You can even connect your blog directly to Google Analytics for a more detailed look.

Hang onto your memories

Save the moments that matter. Blogger lets you safely store thousands of posts, photos, and more with Google for free.

Join millions of others

Whether sharing your expertise, breaking news, or whatever’s on your mind, you’re in good company on Blogger. Sign up to discover why millions of people have published their passions here.

CREATE YOUR BLOG
Help
Help Center
Help Forum
Video Tutorials
Community
Blogger Buzz
Developers
Blogger API
Developer Forum
Terms of Service
Privacy
Content Policy
Afrikaans‎
Amharic - አማርኛ‎
Arabic - العربية‎
Basque - euskara‎
Bengali - বাংলা‎
Bulgarian - български‎
Catalan - ‪Català‬‎
Chinese (Hong Kong) - 中文（香港)‎
Chinese (Simplified) - ‪简体中文‬‎
Chinese (Traditional) - 繁體中文‎
Croatian - Hrvatski‎
Czech - Čeština‎
Danish - Dansk‎
Dutch - Nederlands‎
English
English (United Kingdom)‎
Estonian - eesti‎
Filipino‎
Finnish - Suomi‎
French (Canada) - Français (Canada)‎
French (France) - Français (France)‎
Galician - galego‎
German - Deutsch‎
Greek - Ελληνικά‎
Gujarati - ગુજરાતી‎
Hebrew - עברית‎
Hindi - हिन्दी‎
Hungarian - magyar‎
Icelandic - íslenska‎
Indonesian - Indonesia‎
Italian - Italiano‎
Japanese - 日本語‎
Kannada - ಕನ್ನಡ‎
Korean - 한국어‎
Latvian - latviešu‎
Lithuanian - lietuvių‎
Malay - Bahasa Melayu‎
Malayalam - മലയാളം‎
Marathi - मराठी‎
Norwegian - norsk‎
Persian - فارسی‎
Polish - polski‎
Portuguese (Brazil) - Português (Brasil)‎
Portuguese (Portugal) - português (Portugal)‎
Romanian - română‎
Russian - Русский‎
Serbian - српски‎
Slovak - Slovenčina‎
Slovenian - slovenščina‎
Spanish (Latin America) - Español (Latinoamérica)‎
Spanish (Spain) - Español (España)‎
Swahili - Kiswahili‎
Swedish - Svenska‎
Tamil - தமிழ்‎
Telugu - తెలుగు‎
Thai - ไทย‎
Turkish - Türkçe‎
Ukrainian - Українська‎
Urdu - اردو‎
Vietnamese - Tiếng Việt‎
Zulu - isiZulu‎